# #####################
#   #       #         #
### ####### # ### ### #
# #       #   # # # # #
# ####### # ### # # # #
#       # #     # #   #
# ##### # ##### # #####
# #     #     # # #   #
# # ######### # # # # #
# # #       # # #   # #
### # ### ### # ##### #
#   # # # #   # # #   #
# ### # # # ### # # # #
#     # #   #     # # #
# ##### ########### # #
#         #         # #
######### # # ####### #
#       # # # #     # #
### # ### # # ##### # #
#   # #   # #     #   #
# ##### ######### # ###
#                 #   #
##################### #
