# ###
# # #
# # #
#   #
### #
