# ###
#   #
# # #
#   #
### #
