# ###################################################################################################
# #                   #   #   #                   #                     #       #             #     #
# ### ### ########### # # # # ### # ######### ##### # ######### ####### ##### # # ### ####### # ### #
#   #   #   #       # # # # #   # # #       # #     #     #   # #   # #   #   # # #   #     # # # # #
### ### ### ####### # # # # ### ### ### ### # # ######### # # ### # # ### # ### ### ### ##### # # # #
# #   # #   #     # #   #   # #     #   #   # #     #   #   #   # # #   # #   #   # #   #   # #   # #
# ### # # ### ### # ######### ####### ### ### ##### ### ####### # # # # # ### ### # # ### # # ### # #
#   # # # #     # #       #     #   #   #   # #   #       #   #   # # # #     # #   #     # #   # # #
# # # ### # ##### # # ##### # # # ### # ##### # # ####### # # ##### # # ####### ##### ##### ### ### #
# # #   # #   #   # #   #   # #   #   #       # #     #     #     # # #   #   #   #     #     #     #
# # ### # ### # ### ### # ### ##### ########### ### ### ##### ##### ### # ### # # # ##### ### ##### #
# # #   #     # # #   # #   #     # #             #     #   # #     #   #   #   #   #     # # # #   #
# ### ######### # ### # ### ##### # # ################### # ### ##### ##### ######### ##### # # # ###
#     #     #   #     #   #   #   # #   #       #     #   #     # #       #           #   #     # # #
# ##### ### # ### ####### ### # ### ### ####### # ### # ######### # ##### # ####### ### # # ##### # #
#     #   # # # # #     #     # #   #   #       # #   # #             #   # #   #   #   # #   #   # #
##### ### # # # # # ### ####### # ### ### ##### # # ### ####### ####### ### # # ### # ### ##### ### #
#   #     # # #     #     #     #   # #     # # # #     #     #   #   #   # # #   # #   #       #   #
# ######### # ##### ####### ####### # ##### # # # ####### ### ##### # ### ### ### ##### ########### #
#     #     #   #   #     #     #   #     # #   # #       #         #   #   #   #     #           # #
# ### # ##### # ##### ### ##### # ####### # # ### # ##### ############# ### ### ### ############# # #
# #   #   # # #   #   # # #   #     #       # #   # #   # #           # #     # # # #         #   # #
# # ##### # # ### # ### # # # # ##### ######### ### # # # # ######### # # # ### # # # ##### ### ### #
# #     # #     #   #   #   # # #   # # #       # #   # #           # # # # #   # #   #   #   #   # #
# ##### # ##### ##### ####### ### # # # # ####### ### ######### ##### # # # # ### ##### # ### ### # #
#   #   #   #   #   #       #     # # # # #   #   #   #   #   # #     #   # # #       # #       #   #
### # # ### ### ### # ### # ####### # # # ### # # # ### # # # ### ########### ####### # ########### #
#   # # # #   #   #   #   # #     #   # #   #   #   #   #   #   #   #         #   #   #           # #
# ### # # ### ### ##### ##### ### ##### ### ####### # ######### ### # ######### # # # ######### # # #
#   # # #   # # #     # #     # #         # #     # # #       # #   # #   #     # # #   #   #   # # #
### # # # ### # ##### # # ##### # ### ##### # ### ### # ##### # # ### # # # ##### # ### ### # ##### #
#   # #   #   # #   # # #   #   # #   #     #   # #   # #   #   #   #   #   # #   #   #   # #       #
# ### ##### ### # # # # ### # ### # ### ####### # # ### # # ##### # ######### # ##### ### # #########
#   # #     #   # # # #   # # #   # #   #       #   # # # #       #   #       # #     #   #         #
### # # ##### ### # # # # # # # ##### ### # ######### # # ##### ### # ### ##### # # ### ##### ##### #
#   #   # #     # #   # #     #   #   #   # #   #       # #   # #   #     #     # # #     #   #     #
# ####### # ### # ##### ##### ### # ### # ### # ### ####### # # # ####### # ##### # ##### # ####### #
#   #     #   #   #   # #   # #   #   # # #   #   #     #   # # #   #   # #   # # #   #   #       # #
### # ### ### ##### # ### # ### ##### # ### ##### ##### # ### # ### # ### ### # # ### ### ### ### ###
# # # #     #   #   #   # #     #     #   # #   #   # #   # # # #   # #   # # #     #   #   #   #   #
# # # ######### # # ### # ##### # ####### # ### ### # ##### # # # ### # ### # ####### # ### # ##### #
#   #   #       # # #     # #   # #       #   #   # #   #   # # # #       # #   #   # # # # # #     #
# ##### # ######### ####### # ### ##### # ### # # # # # # # # ### ####### # ### # # ### # # ### #####
#     # # #       #     #   #   # #   # # #   # # # # #   #       #   #   #   #   #   # #     # #   #
##### # # ### ### # ### # # ### # # # # ### ### # # ############# # # # ##### ####### # ##### # # # #
# #   #       # # #   # # #     #   # #   # #   # #   #       #   # # # #   # #   #   #     # #   # #
# # ########### # # ### # ########### # # # # ####### # ##### ##### # # # # # # # # ### ### # ##### #
# #       #     # # #   # #   #     # # #     #       # #   #       # #   #   # # # #   # # #       #
# ####### # ### # # # ### # # # # # # ######### ##### # # ########### ### ##### # # # ### # ####### #
#       # # # #   # #   # # #   # # #         # #   # # #         #   #   #     # # #   # #   #   # #
# ####### # # ##### ### # # ##### ########### # # # ### # ####### # ####### ##### # ### # ### # ### #
#   #     # # #   # #   # #   # #       #     #   #     #     #   # #     #   # # #   #   #   #     #
# # # ##### # # # # # ####### # ####### # ########### ######### ### # ### ### # # ### # ### ### #####
# # # #   # # # # # #       #         # #           # #       #   #   # #       #   # # #   #   #   #
### # # ### # # # # ##### # # ######### ########### # # ##### ### ##### ########### # ### ### ### # #
#   # #   # #   #   #   # #   #     #   #       #   #   #   # #   #   #   #         #   # #   #   # #
# ### ### # # ####### # ####### ### # # # ##### # ####### # # # # # # ### # ####### ### # # ### #####
#     #   # #   #     #     #   #     #   # #   #     #   # #   #   # #   #       #   #   #   #     #
# ##### ### ### # # ####### # ############# # ####### # ### ######### # ######### # ######### # ### #
#     # #   #   # # #   #     #   #     #     #     # #   #     #   #   #         # #         # #   #
##### # # ####### # # # # ##### # ### ### ####### ### ##### ### ### ### # ########### ########### # #
#   # #         # # # # #   #   #   # #   #       #   #   #   #     #   #             #   #       # #
### # ######### # ### # ##### ##### # # ### ####### ### # ### # ##### ################# ### # ##### #
#   #       #   # #   #     # # #   #   #   #       #   # #   # #     #     #         #   # #     # #
# ######### # ### # ####### # # # ### ### # # ####### ### # ##### ##### ### # ####### # # # ##### ###
# #       # #     #   #   #   # # #     # # #   #   #   # # #     #     # # #   #   #   #   #   #   #
# # # ##### ####### # ### ##### # ##### ### ### # # ### # # # ####### ### # ### # # ######### # ### #
# # #       #     # #   #             #   #   #   # #   # # #   #     #   #   # # # #     # # # #   #
# # ######### ### ### # ############# ### # ####### # ### # ### # ####### ### # # # # # # # # # # ###
# #     #     # #   # # #     #   # # #   #     #   #   # #   # # #     #   # #   # # # # # # # #   #
# ##### # ##### ### # # # ### # # # # # ### # # # ### # # ### # # # ### # # # ##### ### # # # # ### #
#     # # #   #   # # #     # # # #   #   # # # # #   # #     #   # #     # #     #     # #   #   # #
### ### # # ### # # ######### # # ### ### ### ### # ### ##### ##### ############# ####### ##### ### #
#   #   # #     # #         #   #   # #       #   #   # # #       # #           #   #   #     #   # #
# ### ### ### ### ######### ####### # ####### # ##### # # # ##### # # ####### # ### # # ##### ### # #
#   # # #   # #           # #     # #       # # # #   # #   #   #   #       # #   # # #     #     # #
# # # # # # ### ######### # # ### # ####### ### # # ### ### # # ########### # ##### # # ######### # #
# # # #   # #   #         # # #     #     #     #   # #   # # #           # #       # # #       # # #
# # # ##### # ##### ####### # ######### # ####### ### ### ### ####### ### # ######### # # ##### # # #
# # #   #   # #   #   #     #     #   # # #       #     #     #     # #   # #     #   #   #   #   # #
### ### # ### # # ### # ######### # # ### # ####### ### ########### # ##### # ### # ####### # ##### #
#     #   #   # #   # # #         # #   #   #       # #     #       #     # # # #   #       # #     #
# ######### # # ### # # ### ### ### ### # ######### # ##### # # ######### # # # ####### ##### # ### #
#           #   #   # #   # #   #   #   # #         # #     # #       # #   # #         #     # #   #
# ############### ####### # ##### ### ### ### ####### # ##### ##### # # ##### # # ####### ##### #####
#   #           #       # #       # # #       #           #     # # #       # # # #     #   #   #   #
### # # ####### ####### # # ####### # ####### ########### ##### # # ######### # ### ### ##### ### # #
# # # #     #   #     #   #       # # #   #   #   #     #   # # # #           # #   # #     # #   # #
# # ##### # ### ##### ##### ##### # # # # ##### # # ### ### # # # ############# # ### ##### # # ### #
#   #   # #   #     # #     #   #   #   #       # #   # # # #   #       #       #   # #     #   #   #
# ### # ##### ##### # # ##### # ### ############# ### # # # # ### ##### ##### # ### # # ##### ### # #
# #   #     # #   # #   #   # #   #   #         # #   # #   #     #   # #     # # # #       #   # # #
# # ####### # # # # ##### # # ### ##### ####### # # ### # ########### # # ##### # # ####### ### # ###
# # #   #   #   # # #     # #   # #     #     # #     # #   #   #     #   #   #   #   #     #   #   #
# # ### # ### ### # # ##### # # # # ##### # ### ##### # ### # # # # ####### # # ##### # ########### #
# #   # # #   #   #   # #   # # #   # #   #   # #   # # # #   # # #         #   #   # # #         # #
# ### # # # ### ####### # ##### ##### # ##### # # # ### # ##### ########### ##### # # # # # ##### # #
# #   # # # #   #     #   #     #   #   # #   #   #     #     #           #   #   # # # # #   #   # #
# # ### # ### ### ##### ##### ### # # ### # ############# # ############# ##### ### # # ##### # ### #
#   #         #               #   #       #               #                     #     #       #     #
################################################################################################### #
